




1111111
1000001
1000001
10P0001
1000001
100C001
1111111

1111111
1111111
1111111
1111101
1111101
1111111
1111111

1111111
1111111
1111101
1111101
1111111
1111111
1111111

1111111
1111101
1111101
1111111
1111E11
1111111
1111111

1111111
1000001
1C01111
1001111
1000E11
1111111
1111111


