11111111111111111111
10000000000000000001
10000000000000000C01
100C0000000000000001
10000000000000000001
10000000000000000001
10000C00000000000001
1000000000000000P001
11111111111111111111
11111111111111111111
11101111111110111111
11111111111111111111
11111111111111111111

11111111111111111111
11111111111111111111
11101111111110111111
11111111111111111111
11111110001111111111
11111110001111111111
11111111111111111111
11111111111111111111
11111111111111111111
11111111111111111111
11101111111111111111
11111111111111111111
11111111111111111111

11111111111111111111
11111111111111111111
11101111111110111111
11111110111111111111
11111110001111111111
11111111001111111111
11111111111111111111
11111111111111111111
11111111111111111111
11111111111111111111
11101111111111111111
11111111111111111111
11111111111111111111

11111111111111111111
11111111111111111111
11101111111110111111
11111110011111111111
11111111001111111111
11111111001111111111
11111111111111111111
11111111111111111111
11111111111111111111
11111111111111111111
11101111111111111111
11111111111111111111
11111111111111111111

11111111111111111111
11111111111111111111
11101111111110111111
11111111001111111111
11111111001111111111
11111111001111111111
11111111111111111111
11111111111111111111
11111111111111111111
11111111111111111111
11101111111111111111
11111111111111111111
11111111111111111111

11111111111111111111
11111111111111111111
11101111111110111111
11111111100111111111
11111111001111111111
11111111001111111111
11111111111111111111
11111111111111111111
11111111111111111111
11111111111111111111
11101111111111111111
11111111111111111111
11111111111111111111

11111111111111111111
11111111111111111111
11101111111110111111
11111111110111111111
11111111000111111111
11111111001111111111
11111111111111111111
11111111111111111111
11111111111111111111
11111111111111111111
11101111111111111111
11111111111111111111
11111111111111111111

11111111111111111111
11111111111111111111
11101111111110111111
11111111111111111111
11111111000111111111
11111111000111111111
11111111111111111111
11111111111111111111
11111111111111111111
11111111111111111111
11101111111111111111
11111111111111111111
11111111111111111111

11111111111111111111
11111111111111111111
11101111111110111111
11111111111111111111
11111111001111111111
11111111000111111111
11111111110111111111
11111111111111111111
11111111111111111111
11111111111111111111
11101111111111111111
11111111111111111111
11111111111111111111

11111111111111111111
11111111111111111111
11101111111110111111
11111111111111111111
11111111001111111111
11111111001111111111
11111111100111111111
11111111111111111111
11111111111111111111
11111111111111111111
11101111111111111111
11111111111111111111
11111111111111111111

11111111111111111111
11111111111111111111
11101111111110111111
11111111111111111111
11111111001111111111
11111111001111111111
11111111001111111111
11111111111111111111
11111111111111111111
11111111111111111111
11101111111111111111
11111111111111111111
11111111111111111111

11111111111111111111
11111111111111111111
11101111111110111111
11111111111111111111
11111111001111111111
11111111001111111111
11111110011111111111
11111111111111111111
11111111111111111111
11111111111111111111
11101111111111111111
11111111111111111111
11111111111111111111

11111111111111111111
11111111111111111111
11101111111110111111
11111111111111111111
11111111001111111111
11111110001111111111
11111110111111111111
11111111111111111111
11111111111111111111
11111111111111111111
11101111111111111111
11111111111111111111
11111111111111111111

11111111111111111111
11000000000000011111
1100E000000000011111
11000000000000011111
11000000000000011111
11000000000000011111
11000001111111111111
11000001111111111111
11000001111111111111
11000001111111111111
11000001111111111111
11000001111111111111
11111111111111111111
