1111111
1CCCCC1
1CCCCC1
1CPCC01
1CCCC01
1CCCCC1
1111111

1111111
1111111
1111111
1111101
11111C1
1111111
1111111






1111111
1111111
1111101
11111C1
1111111
1111111
1111111




1111111
1111101
11111C1
1111111
1111E11
1111111
1111111





1111111
10CCCC1
1CC1111
1CC1111
1CCCE11
1111111
1111111

1111111
1C11111
1111111
1111111
1111111
1111111
1111111










