1111111
1000PC1
1110001
111E111
111F111
1111111
